%%%%%%%%%%%%%%%%%%%%%%%%%%%%%%%%%%%%%%%%%%%%%%%%%%%%%%
%.   .         .%									 %
%      .        %%									 %
% %G%%%%%      .%%									 %
% P     %.      %%									 %
%.      %       %%									 %
%       %.     .%%									 %
%	         										 %
%%													 %
%%													 %
%%													 %
%%													 %
%%													 %
%%													 %
%													 %
%													 %
%													 %
%													 %
%%%%%%%%%%%%%%%%%%%%%%%%%%%%%%%%%%%%%%%%%%%%%%%%%%%%%%
